com/appodeal/ads/AppodealRequestCallbacks = Com.Appodeal.Ads.IAppodealRequestCallbacks
  onClick(ILjava/lang/String;)V = OnClick(int, string)
  onImpression(ILjava/lang/String;)V = OnImpression(int, string)
  onRequestFinish(ILjava/lang/String;Z)V = OnRequestFinish(int, string, bool)
  onRequestStart(ILjava/lang/String;Ljava/lang/String;)V = OnRequestStart(int, string, string)
  onWaterfallFinish(IZ)V = OnWaterfallFinish(int, bool)
  onWaterfallStart(I)V = OnWaterfallStart(int)
com/appodeal/ads/BannerCallbacks = Com.Appodeal.Ads.IBannerCallbacks
  onBannerClicked()V = OnBannerClicked()
  onBannerFailedToLoad()V = OnBannerFailedToLoad()
  onBannerLoaded(IZ)V = OnBannerLoaded(int, bool)
  onBannerShown()V = OnBannerShown()
com/appodeal/ads/BannerView = Com.Appodeal.Ads.BannerView
  <init>(Landroid/content/Context;Landroid/util/AttributeSet;)V = .ctor(Android.Content.Context, Android.Util.IAttributeSet)
com/appodeal/ads/InterstitialCallbacks = Com.Appodeal.Ads.IInterstitialCallbacks
  onInterstitialClicked()V = OnInterstitialClicked()
  onInterstitialClosed()V = OnInterstitialClosed()
  onInterstitialFailedToLoad()V = OnInterstitialFailedToLoad()
  onInterstitialLoaded(Z)V = OnInterstitialLoaded(bool)
  onInterstitialShown()V = OnInterstitialShown()
com/appodeal/ads/MrecCallbacks = Com.Appodeal.Ads.IMrecCallbacks
  onMrecClicked()V = OnMrecClicked()
  onMrecFailedToLoad()V = OnMrecFailedToLoad()
  onMrecLoaded(Z)V = OnMrecLoaded(bool)
  onMrecShown()V = OnMrecShown()
com/appodeal/ads/MrecView = Com.Appodeal.Ads.MrecView
  <init>(Landroid/content/Context;Landroid/util/AttributeSet;)V = .ctor(Android.Content.Context, Android.Util.IAttributeSet)
com/appodeal/ads/NonSkippableVideoCallbacks = Com.Appodeal.Ads.INonSkippableVideoCallbacks
  onNonSkippableVideoClosed(Z)V = OnNonSkippableVideoClosed(bool)
  onNonSkippableVideoFailedToLoad()V = OnNonSkippableVideoFailedToLoad()
  onNonSkippableVideoFinished()V = OnNonSkippableVideoFinished()
  onNonSkippableVideoLoaded()V = OnNonSkippableVideoLoaded()
  onNonSkippableVideoShown()V = OnNonSkippableVideoShown()
com/appodeal/ads/RewardedVideoCallbacks = Com.Appodeal.Ads.IRewardedVideoCallbacks
  onRewardedVideoClosed(Z)V = OnRewardedVideoClosed(bool)
  onRewardedVideoFailedToLoad()V = OnRewardedVideoFailedToLoad()
  onRewardedVideoFinished(ILjava/lang/String;)V = OnRewardedVideoFinished(int, string)
  onRewardedVideoLoaded()V = OnRewardedVideoLoaded()
  onRewardedVideoShown()V = OnRewardedVideoShown()
